#Datos extraidos de http://upload.wikimedia.org/wikipedia/commons/a/a9/Provincias_de_Espa%C3%B1a.svg
alava,araba=>vizcaya,bizkaia,gipuzcoa,gipuzkoa,navarra,nafarroa,rioja,burgos
albacete=>cuenca,valencia,alicante,alacant,murcia,jaen,ciudadreal
alicante,alacant=>valencia,murcia,albacete
almeria=>granda,murcia
asturias,asturies=>cantabria,leon,llion,lugo
avila=>segovia,madrid,toledo,caceres,salamanca
badajoz=>caceres,toledo,ciudadreal,cordoba,sevilla,huelva
barcelona=>gerona,girona,tarragona,lleida
burgos=>cantabria,alava,araba,rioja,soria,segovia,valladolid,palencia
caceres=>salamanca,avila,toledo,badajoz
cadiz=>huelva,sevilla,malaga,ceuta
cantabria=>asturias,asturies,vizcaya,bizkaia,burgos,palencia,leon,llion
castellon,castello=>tarragona,valencia,cuenca,teruel
ceuta=>cadiz,malaga
ciudad real=>toledo,cuenca,albacete,jaen,cordoba,badajoz
cordoba=>ciudadreal,jaen,granada,grana,malaga,sevilla,badajoz
cuenca=>guadalajara,teruel,castellon,castello,valencia,albacete,ciudadreal,toledo,madrid
gerona,girona=>lerida,lleida,barcelona
granada,grana=>jaen,albacete,murcia,almeria,malaga,cordoba
guadalajara=>soria,zaragoza,teruel,cuenca,madrid,segovia
guipuzcoa,gipuzkoa=>navarra,nafarroa,alava,araba,vizcaya,bizkaia
huelva=>badajoz,sevilla,cadiz
huesca,uesca=>lerida,lleida,tarragona,zaragoza,navarra,nafarroa
jaen=>ciudadreal,albacete,granada,grana,cordoba
coruna=>lugo,pontevedra
rioja=>alava,araba,navarra,nafarroa,zaragoza,soria,burgos
palmas=>tenerife
leon,llion=>asturias,asturies,cantabria,palencia,valladolid,zamora,orense,ourense,lugo
lerida,lleida=>gerona,girona,tarragona,zaragoza,huesca,uesca
lugo=>asturias,asturies,leon,orense,ourense,pontevedra,coruna
madrid=>segovia,guadalajara,cuenca,toledo,avila
malaga=>cadiz,sevilla,cordoba,granada,grana
murcia=>alicante,alacant,almeria,granada,grana,albacete
navarra,nafarroa=>huesca,uesca,zaragoza,rioja,alava,araba,guipuzcoa,gipuzkoa
orense,ourense=>lugo,leon,zamora,pontevedra
palencia=>cantabria,burgos,valladolid,leon
pontevedra=>coruna,lugo,orense,ourense
tenerife=>palmas
salamanca=>zamora,valladolid,avila,caceceres
segovia=>burgos,soria,guadalajara,madrid,avila,valladolid
sevilla=>badajoz,cordoba,malaga,cadiz,huelva
soria=>rioja,zaragoza,guadalajara,segovia,burgos
tarragona=>barcelona,castellon,castello,teruel,zaragoza,lerida,lleida
teruel=>zaragoza,tarragona,castellon,castello,valencia,cuenca,guadalajara
toledo=>madrid,cuenca,ciudadreal,badajoz,caceres,avila
valencia=>castellon,castello,alicante,alacant,albacete,cuenca
valladolid=>palencia,burgos,segovia,avila,salamanca,zamora,leon
vizcaya,bizkaia=>cantabria,gipuzkoa,guipuzcoa,alava,araba
zamora=>leon,valladolid,salamanca,orense,ourense
zaragoza=>navarra,nafarroa,huesca,uesca,tarragona,teruel,guadalajara,soria
